{
    "simple": {
        "temp_width": 16,
        "temp_height": 9,
        "templates": [
            "0010010000000000001001000000010000100T00000001100010000000000010001000000000001000T00000000000T000000011000000000000000T000000000000000000000000",
            "0000000000000000000000000001100000010010000100000001111000000000000T00T0000000000000000000000001000000000000000100000000000000110000000000000000",
            "00000000000000000010000000000000001100000000010000T1000000000100000T0000000001100000000000000T0000000000001000000000000000T000000000000000000000",
            "00000000000000000011100000000000000T000000011000000000000000000000000000000000000010000000000000001000000000000000T00000000000100000000000000000",
            "00000000000000000000000001000000000000000T000000000100000000000000011000000000000000000000010000000000000011001000000000000000100110000000000000",
            "000000000000000000000000000000000000000000000000000000000000000000100000000100000011100000010000000T00000011000000000000001T00000000000000000000",
            "00000000000000000000000000100000000000000011100000100000000T1000001000000000000000101000000000000011100000000000000T0000000000000000000000000000",
            "000000000000000000000000000100000000000000010000000000000001000111100000000100010T10000000010001000000000001000T00000000000100000000000000000000",
            "000000000000000000100000000000000011100000010000000T1000000T000000001000000010000000T0000000T000000000000001000000000000000T00000000000000000000",
            "000000000000000000100001000000000011000T0000010000T1000000110100000T0100001T01100000011000100T0001000T1100000000011000T0000000000000000000000000",
            "0000000000000000001000000000010000T0001111000T00000000T00T00000000000000000000000000000000000000000000000000000000100000000001000000000000000000",
            "0000000000000000000000000000111000001000000010T00000T00000001000000000000000T0000001000000000000000100000000000001110000011111100000000000000000",
            "000000000000000000011000000000000001T0000001100000010000000T10000001000000001000000100000000100000011000000010000000T000000110000000000000000000",
            "000000000000000000000000000011000011110000000000000001000000000000000000000000000000000000110000000000000001100000000000000000000000000000000000",
            "000000000000000001000000000000000100000000000000010000000000000001001000100010000100T000T000T000010000000000000001000000000000000000000000000000"
        ]
    },
    "store": {
        "temp_width": 16,
        "temp_height": 9,
        "templates": [
            "1111111DD111111110T00T0000T00T0110000000000000011000000000000001D00000AAAA00000D100000T00T000001100000000000000110000000000000011111111DD1111111",
            "0000111DD1110000000110T00T0110000011T000000T1100111T00AAAA00T111D00000AAAA00000D111000AAAA000111001100000000110000011000000110000000111DD1110000",
            "0111110000111110110T01000010T0111100011DD1100011011000T00T00011000D00AAAAAA00D0001100000000001101100011DD110001111100100001000110011110000111110",
            "000000000000000000001111D1111000000010T000T010000000D00AAA00D0000000D00AAA00D000110010000000100001001111D111100000000T0T0T0T00000001100000000010",
            "0000001D100000000000011011000000000011T0T110000000011T0A0T110000000D00AAA00D00000001100A0011000000001100011000000000T11011T000000000001D10000000",
            "0000001DD10000000000001001000000000111100111100011110T0000T01111D000000AA000000D1111000AA0001111000100000000100000011110011110000000001DD1000000",
            "0000001DD10000000001111001111000000D0T0000T0D00000011110011110000000011001100000000001T00T1000000100010AA010000001000100001000000T00011DD1100000",
            "00011100001110000001011DD1101000000100T00T0010000001110AA011100000000D0AA0D000000001110AA011100000010T0AA0T0100000010000000010000001111DD1111000"
        ]
    },
    "puzzle": {
        "temp_width": 32,
        "temp_height": 9,
        "templates": [
            "1111111001111111111111100111111110000000000000010000000000000001110101111011110101111011111111011001010000000111011000000000010110110101111100000000111111011101100100000000011111111000@1000001110101111111110000001011110111011N01000000000001111000000001010111111110011111110011111111110111",
            "111111001111111111111111001111111000T0000T0000T00T0000T0000T000110101010101010111101010101010101101010101010101@@1010101010101011010101010101010010101010101010110101010101010100101010101010101101010101010101DD10101010101010110T0T0T0T0T0T0T00T0T0T0T0T0T0T0111111111111111100111111111111111"
        ]
    }
}